#######
#P    #
# B   #
#    X#
#######