###########
#         #
#  B   B  #
#         #
#    P    #
#         #
#  B      #
#         #
#  X X X  #
###########