############
#P         #
# BB       #
#    X#   X#
############