#################
#P              #
#  # ###### #   #
#  # #    # #   #
#  B      B #   #
#  # #    # #   #
#  # ###### #   #
#               #
#  B     #### ###
#  #  X  #      #
#  #  X  #  X   #
#################