#################
#       #       #
#   P   #   X   #
#       #       #
#   #####   #####
#       #   #   #
#   B   #   B   #
#   #   #   #   #
### # ####### ###
#   #       #   #
#   B       X   #
#   #       #   #
#####       #####
#               #
#       X       #
#               #
#################